18 18 18 18 18 18 18 18 18 18 18 18 18 18 18 18 18 18 18 18 18 18 18 18 18 18 18 18 18 18 18 18 18 18 18 18 18 18 18 18 18 18 18 18 18 18 18 18 18 18
18 18 18 18 18 18 18 18 18 18 18 18 18 18 18 27 18 18 18 18 18 18 18 18 18 18 18 18 18 18 18 18 18 18 18 18 18 18 18 18 18 18 18 18 18 18 18 18 18 18
18 18 18 18 27 18 18 27 18 18 18 18 18 18 18 18 18 18 18 18 18 18 18 27 18 18 18 18 18 27 18 18 18 18 27 18 18 18 18 18 18 18 18 18 18 18 18 18 18 18
18 18 27 18 18 18 18 18 18 18 18 18 18 18 18 18 18 18 18 18 18 18 18 18 18 18 27 18 18 18 18 18 18 18 18 18 18 18 18 18 18 18 18 18 27 18 18 18 18 18
18 18 18 18 18 18 28 19 19 19 29 27 18 18 18 18 18 18 18 27 18 18 18 18 18 18 18 18 18 18 18 18 18 18 18 18 18 18 27 18 18 18 18 18 18 18 18 18 18 18
18 18 18 18 18 28 26 1 1 2 21 18 28 19 19 19 19 19 19 29 18 18 18 18 18 18 28 19 19 29 18 18 18 18 18 18 18 28 19 19 29 18 18 18 18 18 18 27 18 18
18 18 18 18 18 23 1 16 1 1 21 18 23 1 1 1 16 16 16 25 29 18 18 27 28 19 26 1 1 25 29 18 28 19 19 19 19 26 1 1 21 18 18 18 18 18 18 18 18 18
18 18 18 27 18 23 1 1 2 22 30 28 26 1 17 17 17 17 17 1 25 19 19 19 26 1 1 1 1 1 21 28 26 1 1 1 1 1 16 1 25 19 29 18 18 18 18 18 18 18
18 18 18 18 18 31 24 2 22 30 28 26 1 1 17 0 0 0 17 1 1 1 1 1 1 1 1 1 1 1 25 26 1 1 2 1 1 1 1 1 1 1 21 27 18 18 18 18 18 18
18 18 18 18 18 18 31 20 30 28 26 1 1 1 17 0 0 0 17 1 16 16 16 1 1 2 1 1 1 1 1 1 1 1 1 1 1 1 1 1 1 1 21 18 18 18 18 18 18 18
18 18 18 18 18 18 27 18 28 26 1 1 2 1 17 0 0 0 17 1 1 16 16 1 1 1 1 1 16 16 1 1 1 1 1 1 22 20 20 24 2 1 21 18 18 18 18 18 18 18
18 27 18 18 18 18 18 28 26 1 16 16 1 1 17 17 0 17 17 1 1 16 16 16 1 1 1 16 16 16 16 1 1 1 1 1 21 18 18 31 24 1 21 18 18 18 18 18 18 18
18 18 18 18 18 18 18 23 1 16 16 16 16 1 1 4 3 5 1 1 2 16 16 16 1 1 16 16 16 16 16 16 1 1 1 2 21 27 18 18 23 16 21 18 27 18 18 18 18 18
18 18 18 18 18 27 18 23 16 16 16 16 16 1 1 4 3 11 12 1 1 1 16 16 16 1 1 16 16 16 16 16 16 1 1 22 30 18 18 18 23 1 21 18 18 18 18 18 18 18
18 18 18 18 18 18 18 23 1 16 16 16 16 16 1 4 3 3 11 6 12 1 1 16 1 1 1 1 16 16 16 16 16 1 1 21 18 18 18 27 23 1 21 18 18 18 18 18 18 18
18 18 18 27 18 18 18 31 20 20 24 1 1 1 1 14 9 3 3 3 11 12 1 1 1 1 1 1 16 16 16 16 16 1 1 25 19 29 18 18 23 1 21 18 18 18 18 27 18 18
18 18 18 18 18 18 18 18 27 18 31 20 24 2 1 1 14 7 9 3 3 11 12 2 1 1 1 1 1 16 16 16 16 1 1 1 1 25 29 28 26 1 21 18 18 18 18 18 18 18
18 18 18 18 18 18 18 18 18 18 18 18 31 24 1 1 1 1 14 9 3 3 5 1 1 1 1 1 1 1 16 16 16 1 1 1 1 1 25 26 1 2 21 18 18 18 18 18 18 18
18 18 18 18 18 18 18 18 18 18 18 18 18 23 1 1 1 1 1 14 9 3 11 12 1 1 1 2 1 1 1 16 16 16 1 2 1 1 1 1 1 1 21 18 27 18 18 18 18 18
18 18 18 18 18 27 18 18 18 18 18 27 18 23 1 1 1 2 1 1 4 3 3 11 12 1 1 1 1 1 1 1 1 1 1 1 1 1 16 16 1 1 21 18 18 18 18 18 18 18
18 18 27 18 18 18 18 18 18 18 18 18 18 23 1 1 1 1 1 1 14 9 3 3 11 12 1 1 1 1 1 1 1 1 13 6 12 1 16 1 1 22 30 18 18 18 18 18 18 18
18 18 18 18 18 18 18 18 18 18 18 18 18 23 1 1 1 16 1 1 1 14 9 3 3 11 12 1 1 16 16 1 1 1 4 3 5 1 1 1 1 21 18 18 18 18 18 18 18 18
18 18 18 18 27 18 18 18 18 18 27 18 28 26 1 1 1 1 1 1 1 1 14 9 3 3 5 1 16 16 16 16 16 1 14 7 15 1 1 1 1 25 29 18 18 18 18 27 18 18
18 18 18 18 18 18 18 18 18 18 28 19 26 1 1 1 1 1 1 1 1 1 2 14 9 3 5 1 1 16 16 16 16 16 1 1 1 2 1 1 1 1 21 18 18 18 18 18 18 18
18 18 18 18 18 18 18 18 28 19 26 1 1 1 1 16 1 1 1 1 1 1 1 1 4 3 5 1 16 16 16 16 16 16 16 1 1 1 22 24 1 1 21 18 18 18 18 18 18 18
18 27 18 18 18 27 18 28 26 1 1 1 2 1 1 1 1 1 2 1 1 1 1 1 4 3 5 1 1 1 16 16 16 1 1 1 1 1 21 23 1 2 21 18 27 18 18 18 18 18
18 18 18 18 18 18 18 23 1 1 1 1 1 1 16 1 1 1 1 1 16 1 1 1 4 3 11 12 1 1 1 1 16 16 1 1 1 1 21 23 1 16 21 18 18 18 18 18 18 18
18 18 18 18 18 18 18 23 1 1 1 16 1 1 1 1 1 1 16 1 1 1 1 1 4 3 3 5 2 1 1 1 1 1 1 1 1 1 21 23 1 1 21 18 18 18 18 18 18 18
18 18 18 18 18 18 18 23 1 1 2 1 1 1 1 1 1 1 1 1 1 1 1 1 14 9 3 5 1 1 1 1 1 1 2 1 1 1 21 31 24 1 21 18 18 18 18 18 18 18
18 18 18 18 18 18 18 23 1 1 1 1 1 1 16 1 1 1 1 1 1 2 1 1 1 4 3 11 6 6 6 6 6 6 12 1 1 1 21 27 31 20 30 18 18 18 18 18 18 18
18 18 18 18 18 18 18 23 1 1 1 16 1 1 1 1 1 16 1 1 1 1 1 13 6 8 3 3 3 3 3 3 3 3 5 1 1 1 25 29 18 18 18 18 18 18 27 18 18 18
18 18 18 18 18 27 18 23 1 1 1 1 1 1 1 1 1 1 1 1 1 1 1 4 3 3 3 10 7 7 7 7 9 3 5 1 1 1 1 25 19 29 18 18 18 18 18 18 18 18
18 18 18 18 18 18 18 31 20 20 24 1 1 2 13 6 6 6 6 6 2 1 1 4 3 10 7 15 1 1 1 1 4 3 11 12 2 1 1 1 1 21 27 18 18 18 18 18 18 18
18 18 18 18 18 18 18 18 27 18 31 24 1 1 4 3 3 3 3 3 11 6 6 8 3 5 1 1 16 1 1 1 4 3 3 5 1 1 1 1 1 25 29 18 18 18 18 18 18 18
18 18 18 18 18 18 18 18 18 18 27 31 24 1 14 7 7 7 9 3 3 3 3 3 3 5 1 1 1 1 2 1 14 9 3 11 12 1 1 1 1 1 21 18 18 18 18 18 18 18
18 18 18 18 18 18 27 18 28 19 19 29 31 24 1 1 1 1 14 7 7 7 7 7 7 15 1 1 1 1 1 1 1 4 3 3 5 1 1 1 2 1 21 18 18 18 18 18 18 18
18 18 18 18 18 18 18 28 26 1 1 25 19 26 1 1 1 1 1 1 1 1 1 2 1 1 1 1 1 1 1 1 1 14 7 7 15 1 1 1 1 1 21 18 18 18 18 18 18 18
18 18 18 18 27 18 18 23 1 2 1 1 1 1 1 1 22 24 1 1 1 1 1 1 1 1 22 20 20 20 20 24 1 1 1 1 1 1 1 1 1 1 21 18 18 18 18 18 27 18
18 18 18 18 18 18 18 23 1 1 1 1 1 1 1 2 21 31 24 1 1 1 16 1 1 22 30 27 18 18 18 23 1 1 1 1 2 1 1 22 20 20 30 18 18 18 18 18 18 18
18 18 18 18 18 18 18 31 24 1 1 1 22 24 1 1 25 29 31 20 24 1 1 1 1 21 18 18 18 27 18 23 1 1 16 1 1 1 22 30 18 18 18 18 18 18 18 18 18 18
18 18 18 18 18 18 18 18 31 24 1 1 25 26 1 1 1 25 29 27 31 24 1 1 1 25 29 27 18 18 28 26 1 1 1 1 22 20 30 18 18 18 18 27 18 18 18 18 18 18
18 18 18 18 18 18 18 18 18 31 24 1 1 1 2 1 1 1 21 18 18 23 1 1 1 1 25 19 19 19 26 1 2 1 1 1 21 18 18 18 18 18 18 18 18 18 18 18 18 18
18 18 18 18 18 18 18 18 18 18 31 20 20 24 1 1 1 22 30 18 18 31 24 1 1 1 1 1 1 1 1 1 1 1 1 1 25 29 18 18 27 18 18 18 18 18 18 18 18 18
18 18 18 18 18 18 27 18 18 18 18 18 18 31 20 20 20 30 18 18 18 18 23 1 1 1 2 1 1 1 1 1 1 1 1 1 1 21 18 18 18 18 18 18 18 18 18 18 18 18
18 18 18 18 18 18 18 18 18 18 18 18 18 27 18 18 18 18 18 18 18 18 31 20 20 20 20 20 20 20 20 20 20 20 20 20 20 30 18 18 18 18 18 18 18 18 18 18 18 18
18 18 18 18 18 18 18 18 18 18 27 18 18 18 18 18 18 18 18 18 27 18 18 18 18 18 18 18 18 18 18 18 18 18 18 18 18 18 18 18 27 18 18 18 18 18 27 18 18 18
18 18 18 18 18 18 18 18 18 18 18 18 18 18 18 18 18 27 18 18 18 18 18 18 27 18 18 18 18 18 18 18 18 18 18 27 18 18 18 18 18 18 18 18 18 18 18 18 18 18
18 18 18 18 18 18 18 18 18 18 18 18 18 18 18 18 18 18 18 18 18 18 18 18 18 18 18 18 18 18 18 18 18 18 18 18 18 18 18 18 18 18 18 18 18 18 18 18 18 18
18 18 18 18 18 18 18 18 18 18 18 18 18 18 18 18 18 18 18 18 18 18 18 18 18 18 18 18 18 18 27 18 18 18 18 18 18 18 18 18 18 18 18 18 18 18 18 18 18 18
18 18 18 18 18 18 18 18 18 18 18 18 18 18 18 18 18 18 18 18 18 18 18 18 18 18 18 18 18 18 18 18 18 18 18 18 18 18 18 18 18 18 18 18 18 18 18 18 18 18
